## Code de la map
```
444444444444444444444444444444448
412222222222222222222222222222248
462222226252222622252222226622248
422225222222222222222252222222248
422222222222222222222222222222248
422244444444444444444444444444448
422255500000000000000005222222248
462222200000000000000552222222248
422200000000000000000222222262248
422220000030000030000222222222248
444444444444444444444444444422248
422226222222222222222222222222248
422222222222222226222222252222248
422222222252226622222226222222248
422222222222222222222222222222248
422244444444444444444444444444448
422622222224222255522555552222648
422622222224226255555565552222248
422222252224222222222222226222248
400225222224262222622522222222248
400022222222222222222222222222248
463002222225222222222222222222748
444444444444444444444444444444449

```

## Information

Largeur : 32
Hauteur : 23

